2 13 31
###############################
#p * *       3*  ** * *      *#
# # # # #*# # #*# # # # # #*# #
#    * *4*** **      *    **  #
# #*# # # # # # #b# # # # # #*#
#      5   *     **      *  **#
# # #*# # # # # #*#*#*#*# # # #
#   *        *   * *x* *      #
# # # # #*# # # # # # #*# #*# #
#   ****         *            #
# # # # # # # # # #*# # # # #*#
#  ** *   *                   #
###############################

