4 13 31
###############################
#p    * **    *               #
# # # #*# # # # # # # # # # # #
#      ** * *  *   * **   *   #
# # # # # #*# # # # # # #*# # #
#*   * *    *b* *   **        #
# # # # # # # # # # # # # #*# #
#    *     *        *    **   #
# #*# # #*#*#*#*# # # # # #*# #
#        *   * *    *   *     #
#*# # # # # # # # # # #*# # #*#
#x*    * **    ** ***         #
###############################

